+--+--+--+--+--+--+
|        |        |
+  +--+  +  +--+  +
|  |     |  |     |
+  +  +--+  +  +--+
|  |        |     |
+  +--+--+  +  +  +
|           |  |  |
+--+  +--+--+--+  +
|  |     |g    |  |
+  +--+--+--+  +  +
|                 |
+--+--+--+--+--+--+