+--+--+--+--+--+--+
|                 |
+  +--+--+--+  +--+
|  |              |
+--+--+  +--+  +--+
|g |        |  |  |
+ -+--+  +  +  +  +
|  |     |  |  |  |
+  +  + -+  +  +  +
|  |  |  |     |  |
+  +--+  +--+--+  +
|                 |
+--+--+--+--+--+--+