+--+--+--+--+--+--+
|                 |
+  +--+  +  +--+--+
|  |     |        |
+--+--+--+--+  +--+
|g+|        |  |  |
+  +--+--+  +  +  +
|        |  |     |
+--+  +--+  +  +  +
|  |     |     |  |
+  +--+  +--+--+  +
|                 |
+--+--+--+--+--+--+